8 19
|-----------------|
|.F.|..-..........|
|..-|.@P......-...|
|.F....-..........|
|.........-.......|
|...-.....|.......|
|.................|
|-----------------|